00000000000000000000000000000000000000000000000000
00000000000000000000000000000000000000000000000000
00000000000000000000000000000000000000000000000000
00000000000000000000000000000000000000000000000000
11111111111111111111111111111111111111111111111111
10000000000000000100044444444000100000000000000001
10000000000000000100044444444000100000000000000001
10000000000000000100044444444000100000000000000001
10000000000000000100044444444000100000000000000001
10000000000000000120000000000002100000000000000001
10000000000000000120000000000002100000000000000001
10000000000000000120000000000002100000000000000001
10000000000000000120000000000002100000000000000001
10000000000000000100000000000000100000000000000001
10000000000000000300000000000000300000000000000001
10000000000000000300000000000000300000000000000001
10000000000000000300000000000000300000000000000001
10000000000000000100000000000000100000000000000001
10000000000000000120000000000002100000000000000001
10000000000000000120000000000002100000000000000001
10000000000000000120000000000002100000000000000001
11111111111111111120000000000002111111111111111111
10000000000000000120000000000002100000000000000001
10000000000000000120000000000002100000000000000001
10000000000000000120000000000002100000000000000001
10000000000000000100000000000000100000000000000001
10000000000000000300000000000000300000000000000001
10000000000000000300000000000000300000000000000001
10000000000000000300000000000000300000000000000001
10000000000000000100000000000000100000000000000001
10000000000000000120000000000002100000000000000001
10000000000000000120000000000002100000000000000001
10000000000000000120000000000002100000000000000001
10000000000000000120000000000002100000000000000001
10000000000000000120000000000002100000000000000001
10000000000000000120000000000002100000000000000001
10000000000000000120000000000002100000000000000001
10000000000000000100000000000000100000000000000001
11111111111111111111111111111111111111111111111111
00000000000000000100000000000000100000000000000000
00000000000000000100000000000000100000000000000000
00000000000000000100000000000000100000000000000000
00000000000000000100000000000000100000000000000000
00000000000000000100000000000000100000000000000000
00000000000000000100000000000000100000000000000000
00000000000000000011111111111111000000000000000000
00000000000000000000000000000000000000000000000000
00000000000000000000000000000000000000000000000000
00000000000000000000000000000000000000000000000000
00000000000000000000000000000000000000000000000000