55555555555555555555555555555555555555555555555555
55555555555555555555555555555555555555555555555555
55555555555555555555555555555555555555555555555555
55555555555555555555555555555555555555555555555555
11111111111111111111111111111111111111111111111111
10000000000000000100044444444000100000000000000001
10000000000000000100044444444000100000000000000001
10000000000000000100044444444000100000000000000001
10000000000000000100044444444000100000000000000001
10000000000000000120000000000002100000000000000001
10000000000000000120000000000002100000000000000001
10000000000000000120000000000002100000000000000001
10000000000000000120000000000002100000000000000001
10000000000000000100000000000000100000000000000001
10000000000000000300000000000000300000000000000001
10000000000000000300000000000000300000000000000001
10000000000000000300000000000000300000000000000001
10000000000000000100000000000000100000000000000001
10000000000000000120000000000002100000000000000001
10000000000000000120000000000002100000000000000001
10000000000000000120000000000002100000000000000001
10000000000000000120000000000002111111111111111111
10000000000000000120000000000002100000000000000001
10000000000000000120000000000002100000000000000001
10000000000000000120000000000002100000000000000001
10000000000000000100000000000000100000000000000001
10000000000000000300000000000000300000000000000001
10000000000000000300000000000000300000000000000001
10000000000000000300000000000000300000000000000001
10000000000000000100000000000000100000000000000001
10000000000000000120000000000002100000000000000001
10000000000000000120000000000002100000000000000001
10000000000000000120000000000002100000000000000001
10000000000000000120000000000002100000000000000001
10000000000000000120000000000002100000000000000001
10000000000000000120000000000002100000000000000001
10000000000000000120000000000002100000000000000001
10000000000000000120000000000002100000000000000001
11111111111111111120000000000002111111111111111111
55555555555555555120000000000002155555555555555555
55555555555555555120000000000002155555555555555555
55555555555555555100000000000000155555555555555555
55555555555555555100000000000000155555555555555555
55555555555555555100000000000000155555555555555555
55555555555555555100000000000000155555555555555555
55555555555555555511111333311111555555555555555555
55555555555555555555555555555555555555555555555555
55555555555555555555555555555555555555555555555555
55555555555555555555555555555555555555555555555555
55555555555555555555555555555555555555555555555555