55555555555555555555555555555555555555555555555555
55555555555555555555555555555555555555555555555555
55555555555555555555555555555555555555555555555555
55555555555555555555555555555555555555555555555555
11111111111111111111111111111111111111111111111111
10000000000000000000100222200100000000000000000001
10004000400040000000300000000100000000000000000001
10000000000000000000300000000100000000000000000001
10004000400040004000300000002100000000000000000001
10000000000000000000100000002100000000000000000001
10004000400040004000120000002100000000000000000001
10000000000000000000120000002100000000000000000001
10000000000000000000120000002100000000000000000001
10004000400040004000120000002100000000000000000001
11111111111111111111120000000100000000000000000001
10000000000000000000100000000300000000000000000001
10004000400040004000100000000300000000000000000001
10000000000000000000100000000300000000000000000001
10000000000000000000100000002111111111111111111111
10004000400040004000120000002100000000000000000001
10000000000000000000120000002100000000000000000001
10000000000000000000120000000100000000000000000001
10004000400040004000120000000300000000000000000001
10000000000000000000300000000300000000000000000001
10000000000000000000300000000300000000000000000001
10004000400040004000300000000100000000000000000001
10000000000000000000100000002100000000000000000001
11111111111111111111100000002100000000000000000001
10000000000000000000120000002100000000000000000001
10004040404040404000120000002100000000000000000001
10000000000000000000120000002111111111111111111111
10004000000000004000120000000300000000000000000001
10000000000000000000120000000300040004000400040001
10004040404040404000120000000100000000000000000001
10000000000000000000100000000100000000000000000001
10000000000000000000300000002100040004000400040001
10000000000000000000300000002100000000000000000001
10000000000000000000300000002100000000000000000001
11111111111111111111100000002111111111111111111111
55555555555555555555100000002155555555555555555555
55555555555555555555100000000155555555555555555555
55555555555555555555100000000155555555555555555555
55555555555555555555100000000155555555555555555555
55555555555555555555100000000155555555555555555555
55555555555555555555100000000155555555555555555555
55555555555555555555111333311155555555555555555555
55555555555555555555555555555555555555555555555555
55555555555555555555555555555555555555555555555555
55555555555555555555555555555555555555555555555555
55555555555555555555555555555555555555555555555555