55555555555555555555555555555555555555555555555555
55555555555555555555555555555555555555555555555555
55555555555555555555555555555555555555555555555555
55555555555555555555555555555555555555555555555555
11111111111111111111111111111111111111111111111111
10000000000000000000001000000100000000000000000001
10000000000000000000001000000100000000000000000001
10000000000000000000001000000100000000000000000001
10000000000000000000001000000100000000000000000001
10000000000000000000001000000100000000000000000001
10000000000000000000001000000100000000000000000001
10000000000000000000001000000100000000000000000001
10000000000000000000001000000100000000000000000001
10000000000000000000001000000100000000000000000001
11111111111111111111111000000100000000000000000001
10000000000000000000001000000100000000000000000001
10000000000000000000001000000100000000000000000001
10000000000000000000001000000100000000000000000001
10000000000000000000001000000111111111111111111111
10000000000000000000001000000100000000000000000001
10000000000000000000001000000100000000000000000001
10000000000000000000001000000100000000000000000001
10000000000000000000001000000100000000000000000001
10000000000000000000001000000100000000000000000001
10000000000000000000001000000100000000000000000001
10000000000000000000001000000100000000000000000001
10000000000000000000001000000100000000000000000001
11111111111111111111111000000100000000000000000001
10000000000000000000001000000100000000000000000001
10000000000000000000001000000100000000000000000001
10000000000000000000001000000111111111111111111111
10000000000000000000001000000100000000000000000001
10000000000000000000001000000100000000000000000001
10000000000000000000001000000100000000000000000001
10000000000000000000001000000100000000000000000001
10000000000000000000001000000100000000000000000001
10000000000000000000001000000100000000000000000001
10000000000000000000001000000100000000000000000001
11111111111111111111111000000111111111111111111111
55555555555555555555551000000155555555555555555555
55555555555555555555551000000155555555555555555555
55555555555555555555551000000155555555555555555555
55555555555555555555551000000155555555555555555555
55555555555555555555551000000155555555555555555555
55555555555555555555551000000155555555555555555555
55555555555555555555551333311155555555555555555555
55555555555555555555555555555555555555555555555555
55555555555555555555555555555555555555555555555555
55555555555555555555555555555555555555555555555555
55555555555555555555555555555555555555555555555555